|||||||||||
|   |  C  |
| | |    C|
| | |     |
|B|       |
|||||||||||
