|||||||||||
|         |
|       C |
| B       |
|         |
|||||||||||
